

NO        ./assets/textures/water.xpm
SO ./assets/textures/gold.xpm
WE ./assets/textures/grass.xpm
EA ./assets/textures/iron.xpm
F    224,224,224

C       153,204,255





                                      111                             
                                     10001
        11111111111111111111          101           11111111111111111111                        
    111100000000000000000000111111111110111111111111000000000000000000001111
11110000000000000S00000000000000000000000000000000000000000000000000000000001111                               
    111100000000000000000000111111111100011111111111000000000000000000001111
        11111111000111111111          101           11111111000111111111
                101                   101                   101
                101                   101                   101
                101                   101                   101
             111000111                101                111000111
            10000000001               101               10000000001                                  
             111000111                101                111000111
                101                   101                   101
                101                   101                   101                                    
                101                   101                   101
                10011111111111111111110001111111111111111111001               
                10000000000000000000000000000000000000000000001                      
                 111111111111111111111101111111111111111111111
                                      101
                                      101                                     
                                      101
                                      101                            
                                     10001
                                    1000001                                            
                                     11011
                                      101
                                      111                                