NO ./assets/textures/grass.xpm
WE ./assets/textures/iron.xpm
SO ./assets/textures/water.xpm
EA ./assets/textures/gold.XPM







F 49,100,0
C 135,206,235





  111                                                   1111111111111111111111111111111111111111111
  101                                                   10000000000000000000000000000000000000000011
  111                                                   100000000000000000000000000000000000000000011
                                                        1000000200000000000000000002000000000000000011
              1111111  111111111111111111111            10000000000000000000000000000000000000000000011
           1111100001  100011111000000001001            100000000000000000000000000000000000000000000011
        1111100000001  100000011110111111101            1000000000000000000000000000000000000000000000011
  1111111100000000001  10000000000011    101            1000000000000000000200000000000000000000000000011
  1000000000000000001  10000000000111   11011111111     10000000000000000000000000010000000000000000000011
  1100000000000000001  10000000000001   11000000001     1000000000000000000000000000000000000000000000000111
  1111111111111111111  11111110111111   11111111101     10000000000000000000000000200000000000000000000000011
                            10001               101     100000000000000000000000021200000000000000000000000011
  11111111111111111     111110001111111111111   101111  1000000000000000000000002111200000000000000000000000011
 111000000000000011    1100000000000000000001   100001  10000000000000000000000211 11200000000000000000000000011
  10000000000000001    1000000000000000000001   1100011 1000000000000000000000211   1120000000000000000000000011
  11000010000000011    1100000000000111110001   1000001 10000000000000000000000211 11200000000000000000000000011
  1000000000000001      1000000000001   10001   1000001 100000000000000000000000211120000000000000000000000001111
  11100020000000011111111000000000001   10001   110000111000000000000S0000000000021200000000000000000000000011
   1111000000000000001000000000000001   10001  111000000000000000000000000000000002000000000000000000000000101
   1100000000000000000000000001111111   11111  1000111111000000000000000000000000000000000000000000000000011
   11111000001100000000000000000001            10001    1000000000000020000000000000000000000000000000000011
 11000000000000000000000000021111111111111111112201    1000000000000020000000000000000000000000000000001111
 111111000000000000000000000000000000000000000000001    1000000000000020000000000000000000000000000001111
     11111100000000000000000211111111111111111200001    1000000000000020000000000000000000000000000001
         1111110000000000111111            111111111    1000000000000000000000000000020000000000000001
             11111111111111                             1000000000000000000000000000000000000000000011
                                                        100000000000000000000000000000000000000000011
                                                        10000000000000000000000000000000000000000011
                                                        1111111111111111111111111111111111111111111