NO        ./assets/textures/water.xpm
SO  ./assets/textures/gold.xpm
WE  ./assets/textures/grass.xpm
EA  ./assets/textures/iron.xpm
S       ./assets/textures/sprite.xpm
C   10,10,10


R    1500 1500
F    160,160,160





  1111111111111
 10000000000001
10000000000000111111111
1111100000000000000001
     11110000000000011111111
        100000000001
        100000000001     111111
        110000000000111111120021
        111111110000000000000011111111
                111111100000000000000111111
              110000000000000000000001
    111111111100000000000000111111111111111111
    1000000000000000000000001
    1000000000000000000000001
    1000000111111111111110011
    10000001            10001
    1000000011111111   100001
    10000000000000001111110001
    10011111111110000000000001
    1001        11111111111001
    1001                  1001
    1001                111001
    1001                100001    11111111111111111111
    1001                100001   11111111111111111111
    1011                10000111100000000000000000001111111111111111111111111111
    1001                102020202020202020202020202020202020202020202020202020201
    1001                100011111111111111111111111111111111111111111111111111111
    10001               11111
    100001
    1110001
    10000001
1111000000001
1000000000001
1000000000001
1000000000001
1000000N00001
1000000000001
1000000000001
1222222222221
1222222222221
1222222222221
1222222222221
1000000000001
1000000000001
1000000000001
1111111111111