C  42,224,254
F    224,224,224
WE      ./assets/textures/grass.xpm
EA      ./assets/textures/iron.xpm

NO          ./assets/textures/water.xpm
SO         ./assets/textures/gold.xpm

  11111111111
 1000000000001
 1000000000001
 1000000000001
 1000000000001
 1000000000001
1000S00000001
 1111111111111